# # # # # # # # # # # # ,
# s h . . p . . . # a # ,
# . . . . . . . . . . # ,
# s # . . # # # # # # # ,
# . # . . . . . . . . # ,
# . . . . . . . . . . # ,
# . . . a T s . # . . # ,
# h . T # . . . . . . # ,
# . . # . . . . . . . # ,
# . . # . # . . # # . # ,
# . a # . . . . . # h # ,
# # # # # # # # # # # # ,